*************************************
*     *                 *           *
*  ****  **********  *  *  *  ****  *
*B    *  *        *  *  *  *  *     *
****  *  ****  *  *  ****  *  *  ****
*     *     *  *  *        *  *     *
*  *******  ****  **********  ****  *
*  *                    *     *     *
*  *  *******  *******  *  *******  *
*  *  *  *     *     *  *  *     *  *
*  *  *  *******  *  *  *  *  *  ****
*     *          B*  *  *     *     *
*  ****************  *  **********  *
*  *              *  *  *        *  *
*  *  *************  ****  ****  *  *
*  *           *     *     *  *     *
*  ****  ****  *  ****  ****  *******
*     *  *  *  *        *          B*
****  *  *  *  **********  *******  *
*  *  *     *              *     *  *
*  *  **********  *  *******  ****  *
*     *        *  *  *              *
*  ****  ****  ****  *  *************
*        *S          *              *
*************************************
