*************************************
*   *       *       *     *         *
* * * ***** * * *** * *** * ******* *
* * *     *  B* * * * *   *       * *
* * *** ******* * * * *********** * *
* *     *       * * *           * * *
* ******* ******* * ***** * ******* *
*   *   * *   *   *   *   * *       *
***** * * *** * * *** * ***** *******
*     *B  *   * * *   *   *   *     *
* * ******* *** * * ***** * ******* *
* * *   *     * * *     * * *       *
* *** * *** * * * ***** * * * *******
*     *   * *   *       * * *B      *
* ******* ************* * * ******* *
* *     *             *   *     *   *
* ***** ************* *** ***** * ***
*     *         *   * *   *   * *   *
***** ******* * * * * * *** * * *** *
*   *       * *  B* * *     * *     *
* * ******* ******* * ******* ***** *
* *   *   *         * *           * *
* *** * * ********* * ***** ***** * *
* * * * *           *     * *   * * *
* * * * ***************** *** * *** *
*   *S                  *     *     *
*************************************