*******************************
*  *              *           *
*  *  *  **********  ****  ****
*     *           *     *     *
*  *************  ****  ****  *
*           *  *        *     *
**********  *  **********  ****
*        *              *     *
*  ****  *  ****************  *
*     *     *              *  *
*************  **********  *  *
*           *     *     *  *  *
*  *******  ****  *  ****  *  *
*  *     *     *  *        *  *
*  *  *******  *  *  *******  *
*  *  *     *     *        *  *
*  *  *  ****************  *  *
*     *  *        *        *  *
*******  *  *  ****  *******  *
*           *                 *
*******************************

