*************************************
*     *                 *           *
*  ****  **********  *  *  *  ****  *
*     *  *        *  *  *  *  *     *
****  *  ****  *  *  ****  *  *  ****
*     *     *  *  *        *  *     *
*  *******  ****  **********  ****  *
*  *                    *     *     *
*  *  *******  *******  *  *******  *
*  *  *  *     *     *  *  *     *  *
*  *  *  *******  *  *  *  *  *  ****
*     *           *  *  *     *     *
*  ****************  *  **********  *
*  *              *  *  *        *  *
*  *  *************  ****  ****  *  *
*  *           *     *     *  *     *
*  ****  ****  *  ****  ****  *******
*     *  *  *  *        *           *
****  *  *  *  **********  *******  *
*  *  *     *              *     *  *
*  *  **********  *  *******  ****  *
*     *        *  *  *              *
*  ****  ****  ****  *  *************
*        *           *              *
*************************************

