*******************************************
*  *              *     *              *  *
*  *  *  ****  ****  *  *  *  *******  *  *
*  *  *  *     *     *  *  *  *     *     *
*  *  *  *  ****  ****  ****  *  *  ****  *
*     *  *     *     *     *     *     *  *
*  ****  **********  ****  **********  ****
*B    *           *  *  *           *     *
****  *******  ****  *  **********  *  *  *
*  *  *     *     *  *     *        *  *  *
*  *  *  *  ****  *  ****  *  **********  *
*     *  *     *  *     *  *     *        *
*  ****  ****  *  *******  ****  *  ****  *
*     *     *     *  *           *  *B    *
****  ****  ****  *  *  **********  *******
*        *  *     *  *  *     *     *     *
**********  ****  *  *  *  *  *  ****  *  *
*        *B    *     *     *  *  *     *  *
*  ****  ****  ****  *******  *  *  ****  *
*  *        *     *  *        *  *  *  *  *
*  *******  ****  *  *  *******  *  *  *  *
*        *  *     *  *        *        *  *
*  ****  *  *  *  **********  ****  ****  *
*     *  *     *  *        *     *  *     *
****  *  **********  *  *******  ****  ****
*     *  *        *  *        *     *     *
*  ****  *  ****  *  ****  *******  ****  *
*     *        *S       *                 *
*******************************************
