*******************************
*  *              *          B*
*  *  *  **********  ****  ****
*     *           *     *     *
*  *************  ****  ****  *
*           *  *        *     *
**********  *  **********  ****
*        *              *     *
*  ****  *  ****************  *
*     *     *              *  *
*************  **********  *  *
*           *     *     *  *  *
*  *******  ****  *  ****  *  *
*  *    B*     *  *        *  *
*  *  *******  *  *  *******  *
*  *  *     *     *        *  *
*  *  *  ****************  *  *
*     *  *        *       B*  *
*******  *  *  ****  *******  *
*           *                S*
*******************************

