*******************************************
*  *              *     *              *  *
*  *  *  ****  ****  *  *  *  *******  *  *
*  *  *  *     *     *  *  *  *     *     *
*  *  *  *  ****  ****  ****  *  *  ****  *
*     *  *     *     *     *     *     *  *
*  ****  **********  ****  **********  ****
*     *           *  *  *           *     *
****  *******  ****  *  **********  *  *  *
*  *  *     *     *  *     *        *  *  *
*  *  *  *  ****  *  ****  *  **********  *
*     *  *     *  *     *  *     *        *
*  ****  ****  *  *******  ****  *  ****  *
*     *     *     *  *           *  *     *
****  ****  ****  *  *  **********  *******
*        *  *     *  *  *     *     *     *
**********  ****  *  *  *  *  *  ****  *  *
*        *     *     *     *  *  *     *  *
*  ****  ****  ****  *******  *  *  ****  *
*  *        *     *  *        *  *  *  *  *
*  *******  ****  *  *  *******  *  *  *  *
*        *  *     *  *        *        *  *
*  ****  *  *  *  **********  ****  ****  *
*     *  *     *  *        *     *  *     *
****  *  **********  *  *******  ****  ****
*     *  *        *  *        *     *     *
*  ****  *  ****  *  ****  *******  ****  *
*     *        *        *                 *
*******************************************

